12 28
******************************
*       * * *              * *
*       * * ****** ******* * *
*       *        *     * *   *
***** ***** *** ** ***** * ***
*   * * * *   *    *     *   *
* *** * * * ******** *** *** *
*       *     **     * * *   *
*** * ******* **** *** * * * *
* *           **     *     * *
* * ***** * **** * *** *** * *
*   *     *      * *   * *** *
*   *P*****      * *** *     *
******************************
