5 18
********************
*              *   *
* ** ** ** ** ** * *
*        P       * *
****************** *
*                  *
********************
