6 6
********
*      *
*   P  *
* **** *
* *    *
* * ****
* *    *
********
